NO ./textures/walls/n_test.xpm
SO ./textures/walls/s_test.xpm
WE ./textures/walls/w_test.xpm
EA ./textures/walls/e_test.xpm
F 123,10,1
C 225,30,132
      11111111111111111111
     1111111111111111111111