NO ./maps/00_test_FewLines.cub 
SO ./maps/02_test_NoPermiss.cub
WE ./maps/04_test_ExtraMidLines.cub
EA ./maps/test_00.cub
F 123,10,1
C 225,30,132


      111111111111111111111111
     1000000000110000000000001
    1011000001110000000000001
   100100040000000000000000011111111
   11111111101100000111000000e0000001
     100000000011000001110111111111111
     11110111111111011100000010001
      111101111111110111010100100011
       11000000110101011100000010001
       100000000000N0001100000010001
      100000M00000000001101010010001
     110000011101010111110111100111
      11110111 1110101 101111010001
      11111111 1111111 111111111111
