NO ./maps/00_test_EmptyLines.cub 
SO ./maps/04_test_ExtraMidLines.cub
WE ./maps/09_test_ExtraPlayer.cub
EA ./maps/test_00.cub
F 123,10,1
C 225,30,132


      1111111111111111111111111
     1000000000110000l000000001
    1011000001110000000000001
   1001000O0000000000000000011111111
   111111111011000001110000000000001
     100000000011000001110111111111111
      11110111111111011100000010001
      111101111111110111010100100011
       11000000110101011100000010001
       100000000000N0001100000010001
      100000000000000011010100104001
     110000011101010111110111100111
      11110111 1110101 101111010001
      11111111 1111111 111111111111