NO ./textures/walls/n_test.xpm
SO ./textures/walls/s_test.xpm
WE ./textures/walls/w_test.xpm
EA ./textures/walls/e_test.xpm
F 123,10,1
C 225,30,132
      1111111111111111111111111
     10000000001100000000000001
    1011000001110000000000001
   10010000000000000000000011111111
   011111111011000001110000000000001
     100000000011101001110111111111111
      11110111111   1011100000010001
      111101111111110111010100100011
11000000110101011100000010001
       100000000000N0001100000010001
      10000000000000001101010010001
     110000011101010111110111100110
      11110111 1110101 101111010001
      11110111 1111111 111111111111