NO ./textures/walls/wall_N.xpm
SO ./textures/walls/wall_S.xpm
WE ./textures/walls/wall_W.xpm
EA ./textures/walls/wall_E.xpm
F 123,10,1
C 225,30,132
111111111111111111111111111
1S000000000011111111110111111111111111
1011000000000000011111011111111111111111
1D111D11111101000000000111111111111
1011100111110111111100000001111111
10111100111101111111111100000000111
10111110D1110111111110000000000111111
1D11111100110111111000000011D111111
1011111110010111000000011111011111
10111111110000000011110111110111
101111000M000111111111011111D1111
1011100000110011111111011111011
1D100000111000001111110111110111
101D111111001110001111000000X1
1000001110011111100011011111111
100010010011111111001101111
1001110001111111111000011111
111111111111111111111111111