NO ./textures/walls/wall_N.xpm
SO ./textures/walls/wall_S.xpm
WE ./textures/walls/wall_W.xpm
EA ./textures/walls/wall_E.xpm
F 123,10,1
C 225,30,132
1111111111111111111111111
111111110000D000000001111
11100D0001110111110111111
111011111100011111D000X11
1110111111011111110111111
1110110000M11110000000011
1110000111111110111111011
111111D111111110111111011
1100000111111110000000001
1101110001100001111111101
1101111100E01100000000001
1111111111111111111111111