NO ./textures/walls/wall_N.xpm
SO ./textures/walls/wall_S.xpm
WE ./textures/walls/wall_W.xpm
EA ./textures/walls/wall_E.xpm
F 123,10,1
C 225,30,132

               1111111111111                                    
               1000000000001                                    
  1111111111   1000000000001                                    
  1000000001   10000000000011111 1111111                        
  1000000001   10000000000010001 1000001                        
  1000000001   11111111100110001 1000001                        
  1000000001      10000000000001 1000001                        
  1000000001      10000000000001 100000111111                   
  100000000111111110001100000001 100000000001                   
  100000000100001100000100000001 111100000001                   
  100000000100001100000100000001  10000000001                   
  111110001100001100000100000001  10000000001                   
      10000000000000000100000001  10000000001                   
      100000000000000001110001111111000111001                   
      100000000011000001000000010000000001001                   
      100000000011000001000000010000000001001                   
      100000000011000001000000010000000001111                   
   111110011000000000001000000010000000001                      
   100000001000000000001000N00010000000001                      
   100000001000011000001000000010000000001                      
   100000001111111000001111001110000000001                      
   100000001     1000001000000010000000001                      
   100000001     1000001000000010000000001                      
   100000001     1000000000000000000000001                      
   100000001     1000000000000000111111111                      
   111111111     1000001000000000001                            
                 1111111000000000001                            
                   10000000000000001                            
                   10000000000000001                            
                   10000000000000001                            
                   11111111111111111                            
