NO ./textures/walls/wall_N.xpm
SO ./textures/walls/wall_S.xpm
WE ./textures/walls/wall_W.xpm
EA ./textures/walls/wall_E.xpm
F 80,20,15
C 75,20,30
1111111111
1000M00001
1001000001
1000N00001
1111111111