NO ./textures/walls/wall_N.xpm
SO ./textures/walls/wall_S.xpm
WE ./textures/walls/wall_W.xpm
EA ./textures/walls/wall_E.xpm
F 123,10,1
C 225,30,132
   11111111111    1
  1000000M00001  101 
  1D111101110111110111
  10000001100000D00001
  1011011  1011111011 
  101100011001100001 
  100111100001 111101 
  100011101101 1000001
  10000000110111D11101 
  10000011 10000011101
  10010001 10111010001  
  10000D0011D111010111
  10000000000W000001
  111111111111111111