NO ./textures/walls/wall_N.xpm
SO ./textures/walls/wall_S.xpm
WE ./textures/walls/wall_W.xpm
EA ./textures/walls/wall_E.xpm
F 123,10,1
C 225,30,132
1111111111
1000000001
1011111101
1010000101
1010S00101
1010111101
1000000001
1111111111