NO ./textures/walls/wall_N.xpm
SO ./textures/walls/wall_S.xpm
WE ./textures/walls/wall_W.xpm
EA ./textures/walls/wall_E.xpm
F 80,20,15
C 75,20,30
1111111111
1000000001
1000000001
1011111101
1010000M101
1010000101
101D011101
1S00000001
1X11111111
111